11111111111111111111111111111111
10000010100000000000000000000001
10000001100000000000010000000001
10000000001001010000000000010011
10000000101000000000000000000001
10001000110010001010000000000001
10000000100000000000000010101001
10100000100000000000000000000001
11111111111111111111111111111111